6,6,6,6,6,6,6,6,6,6,6,6,6,6,6,6,6,6,6,6,6,6,6,6,6
1,1,1,1,1,1,1,1,1,1,1,1,1,1,1,1,1,1,1,1,1,1,1,1,1
1,1,1,1,1,1,1,1,1,1,1,1,1,1,1,3,3,3,3,3,3,3,4,4,3
1,1,1,1,2,2,1,1,1,1,1,1,1,2,1,3,3,3,3,3,3,5,5,5,3
1,1,1,1,1,1,1,1,1,1,1,1,1,0,1,4,4,3,3,4,4,7,4,4,4
6,6,6,6,6,6,6,6,6,6,6,6,6,6,6,6,6,6,6,6,6,6,6,6,6
